0,3,4,5,6,7
3,0,1,2,3,4
4,1,0,1,2,3
5,2,1,0,1,2
6,3,2,1,0,1
7,4,3,2,1,0